all	Tot
allt	Tot
alltihop	Tot
allting	Tot
annan	Ind
båda	Tot
bådadera	Tot
bägge	Tot
denna	Dem
du	Prs
envar	Tot
få	Ind
fler	Ind
flera	Ind
han	Prs
hon	Prs
ingen	Neg
ingendera	Neg
ingenting	Neg
jag	Prs
många	Ind
mången	Ind
mitt	Prs
mycken	Ind
mycket	Ind
någonting	Ind
nånting	Ind
ni	Prs
samtlig	Tot
sån	Ind
sig	Prs
sig	Ind
somlig	Ind
var	Tot
vår	Prs
varandra	Rcp
varann	Rcp
varannan	Ind
vardera	Tot
varje	Tot
vem	Int
vi	Prs
vissa	Ind
